NO ./assets/texture1.xpm
SO ./assets/texture2.xpm
WE ./assets/texture3.xpm
EA ./assets/texture4.xpm

F       90,22,25
C   53,14,15

0000000000000000000000000000000000011111111111  
11111111111111111111111111111111111100000000001
1000000000000000000000000000001000000000000000111111111111111111111111111111111
10000000000000000000000000000010000000000000000000000000000000000000000000001 
10000000000000000000000000000000000000000000000000000000000000001000000000001              
1111111111111111111111111111111111110000000000111111111111111111111111111111111           
11111111111111111111111111111111111100000N00001
0000000000000000000000000000000000011111111111
