F 255,     0         , 0
SO ./textures/kvp/cakir.xpm

NO ./textures/kvp/polat.xpm

WE ./textures/kvp/abuzer.xpm
EA			./textures/kvp/pana.xpm
C 47,     79         , 79

11111111111111111111
10000000000000000011
10011110011111110001
1001  1001001  10001
1001  1001001  10001
1001  1001S011110001
1001  10010000000001
10011111111111111001
10000000000000000001
11111111111111111111

