SO ./path_to_the_south_texture

NO ./path_to_the_north_texture


WE ./path_to_the_west_texture
EA			./path_to_the_east_texture


F 220,00, 0
C 225,30,0





            11111111111111111111111111111111111111
1111111111111000010000011000000000000111111
111111111011100000000000000000111111111111
100101000000000000000000011111111
11100111100000111101100000111000011
1000001111101111111001111111111111
11110111   111111111111111111111
11110111   11  1001       11111111111111111111
11000001   11  1001  1 1110000010001
10000001   11  10001     1000000100011111111111
1111111111111111110111111111111111111111
111111111111111111001111111111111111
110000000000011111100000000000N010011
111111111111111111111111111111111111
                                   1
111111111111111111111111111111111111
100000000000000000000000000000001
100000000000000000000000000000001
111111111111111111111111111111111
