F 0,     255         , 0
SO ./textures/bonewall.xpm

NO ./textures/checker.xpm

WE ./textures/pattern2.xpm
EA			./textures/floorboards.xpm
C 225,30,0

111111111111111111111111111111
100000000011111000000000000001
101100000111111100111111000001
100100000000000000100001000001
100100011111111110111111000001
100100011000000000000000000001
10010001101111111111111111N01
111111111111111111111111111011
                         10001
111111111111111111111111111111




