SO ./path_to_the_south_texture

NO ./path_to_the_north_texture


WE ./path_to_the_west_texture
EA       ./path_to_the_east_texture


F 220,00,0
C 225,30,0








111111111111111111111111111111
1000010000011000000000000111111
11111100001110000000000000000011
1001000000000000000000001111111
1110000000011110110000011100001
1000001111101111111001111111111
11110111   111      111110011111
11110111   11  00   1   11011101111111                 1111111
11000001   11  00   1   1110000010001                  1 00  1
10000001   11  000  1   100000010001                   1 00  1
11111111111111111111111111111111111111111111111111111111111111
111111111111111111111111111111111111                 1111111
110000000000011111110000000000N111
1111111111111111111111111111111111

                                  