SO ./path_to_the_south_texture

NO ./path_to_the_north_texture


WE ./path_to_the_west_texture
EA       ./path_to_the_east_texture


F 220,00,0
C 225,30,0



1111111111111111111111111111
1000010000011000000000000111111
11111100001110000000000000000001
1001000000000000000000001111111
1111111110110000011100001
100000000011000001110111111111111
11110111111111011100000000001
1111011111 111011101010010001                 111111
11000000111101011110000010001                 1  0  1
1000000000000001100000010001                 100  11
10000000000000001101010010001                 1111111
11000001110101011111011110N0111
1111111111111111111111111111111
