F 0,     255         , 0
SO ./textures/random/bonewall.xpm

NO ./textures/random/checker.xpm

WE ./textures/random/pattern2.xpm
EA			./textures/random/floorboards.xpm
C 225,30,0

11111111111111111111111111111
100000000011111000000000000001
101100000111111100111111000001
100100000000000000100001000001
10010001111111111011111100001
100100011000000000000000010111
10010001101111111111111110S11
111111111111111111111111100011
                        110001
111111111111111111111111111111
111111111111111111111111111111




