F 73,     255         , 79
SO ./textures/wolfenstein/eagle.xpm

NO ./textures/wolfenstein/mossy.xpm

WE ./textures/wolfenstein/wood.xpm
EA			./textures/wolfenstein/red_brick.xpm
C 225,30,34

1111111111111111111111111111
1000000000S00000000000000001
1000000000000100000000000001
1000111100000100011110000001
10001  10000000001  10000001
1000111100000100001110000001
1000000000000100000000000001
1000000000100100000000000001
1000000000100100000000000001
1000000000111100000000000001
1111111111111111111111111111


